23,20
1,Flag,6-6,7-11,1
1,Flag,10-10,3-7,1
1,Flag,6-10,7-7,1
1,Flag,10-17,3-3,1
1,Flag,17-17,3-16,1
1,Flag,7-17,11-11,1
1,Flag,10-10,11-17,1
1,Flag,11-15,17-17,1
1,Flag,14-17,16-16,1
1,Wall,15,14,0

2,You,7,15
2,Stop,12,15
2,Win,15,7

3,Baba,8,9
3,Flag,12,13
3,Wall,7,13

4,Is,7,14
4,Is,12,14
4,Is,12,5